xxxxxxxxxxxxxxxxxxxxxxxxxxxxx
x                           x
x            H              x
x                           x
x                           x
x                           x
x     []                    x
x                           x
xxxxxxxxxxxxxxxxxxxxxxxxxxxxx
